290 291 290 291 292 285 291 291 290
282 283 281 283 282 281 285 284 285
277 279 277 279 280 279 280 279 279
271 274 275 273 275 276 276 275 276
266 270 270 270 270 272 271 266 271
270 274 276 275 265 260 264 268 266
274 274 276 275 265 265 270 270 270
279 279 279 279 279 270 279 279 279
285 285 285 285 280 275 285 285 285
