355 351 350 351 352 355 351 351 360
352 343 341 343 342 341 345 344 355
357 339 310 279 280 279 280 310 326
351 314 275 273 275 276 276 305 315
356 301 270 270 270 272 271 310 305
351 282 305 271 305 314 276 305 315
357 339 310 279 310 279 280 310 290
352 343 341 343 342 341 345 344 295
355 351 350 351 352 355 351 351 310
