345 332 273 273 278 272 276 302 323
350 339 276 279 280 279 280 310 326
351 314 310 273 275 276 276 305 315
352 353 351 343 342 341 345 344 355
355 361 373 381 392 375 351 341 330
355 361 370 380 382 371 351 337 336
352 343 361 343 342 361 345 344 345
347 339 310 279 310 279 280 310 326
341 282 305 271 305 314 276 305 315
